rows 16
cols 16
players 2

m ................
m ................
m ................
m .......bbbb.....
m ...a...***b.....
m .......bbbb.....
m ................
m ................
m ................
m ...*............
m ................
m ................
m ................
m ................
m ................
m ................
