rows 11
cols 11
players 2

m ...........
m ...........
m ...........
m ......bbb..
m ...a..**b..
m ......bbb..
m ...........
m ...........
m ...........
m ...*.......
m ...........
