rows 11
cols 11
players 2

m ...........
m ...........
m ..a........
m ...........
m ...a...b...
m ...........
m .a.........
m ...........
m ...........
m ...........
m ...........
