rows 16
cols 16
players 2

m .......%........
m .......%........
m .......%.....b..
m ....a..%........
m ..a....%........
m .....a.%........
m .a.....%....a...
m ....a...........
m ................
m %%%%%%..........
m ....a....a......
m ................
m .a..............
m ................
m .....a.......a..
m %%%%%%%.........
