rows 16
cols 16
players 2

m ................
m .....*..........
m .*..............
m ................
m ...a.*.*........
m ................
m ................
m .*....1.........
m ................
m ...*....*.......
m ................
m ................
m ................
m ................
m ................
m ................
