rows 21
cols 21
players 2

m .....................
m .....................
m .....................
m .....................
m .....................
m .....................
m .....................
m .......0.............
m .....................
m .....................
m .....................
m .....................
m .....................
m .............1.......
m .....................
m .....................
m .....................
m .....................
m .....................
m .....................
m .....................
