rows 11
cols 11
players 2

m ...........
m ...........
m ...........
m ...0.......
m ..aa..bb...
m ..aa..bb...
m ...........
m .......1...
m ...........
m ...........
m ...........
